1111111111111111111111111111111111111111111111111111111111111
1000000000000000001000000000001000000000000001000000000000001
100P000000000000001000000C00001000000000000001000000000000001
100000000000000000100000000000100000000000000100000000C000001
1000000000000000001000000000001000000000000001000000000000001
1000000000000000001001111111111000000000000001000000000000001
1000000000000000001001000000000000000000000001000000000000001
1000000000000000001001000000000000000000000001111111111000001
1000000000000000001001000000000000000000000000000000000000001
1000000000000000001000000000000000000000000000000000000000001
1000000000000000001001111111110011111111111111111111111111111
1000000000000000001001000000000010000000000000000000000000001
1000000000000000001001000000000010000000000000000000000000001
1000000000000000001001000000000010000000000000000000000000001
1000000000000000001001000000000010000000000000000000000000001
1000000C00000000001001000000000010000000000000000000000000001
1000000000000000001001000000000000000000000000000000000000001
1000000000000000001001000000000000000000000000000000000000001
1000000000000000001001000000000000000000000000001111111111001
10000000000000000010010000000000000000000000000010000000E1001
1000000000000000000001000000000000000000000000001000111111001
1000000000000000000001000000000000000000000000001000000000001
1111111111111111111111111111111111111111111111111111111111111